000000000000000000000000000000000000000
000000000000000000000000000000000000000
000000000000020000000000000000000000000
000000000000000000000000000000000000000
000000022222000000000000000000022000000
000000000000000000000000000000211200000
220000000000000002200000000000111120000
112222222222222221100000000000011000000
111111111111111111100000000000001000000
111111111111111111100000000000000000000
111111111111111111100000000000000000000
111111111111111111100000000000000000000
111111111111111111100000000000000000000