00000000000000000000000000000000000000000
00000000000000000000000000000000000000000
00000000000000000000000000000000000000000
00000000000000000000000000000000000000000
00000002222200000000000000000000000000000
00000000000000000000000000000000000000000
22000000000000000220000002200000000000000
11222222222222222110000221120000000000000
11111111111111111110000111110000000000000
11111111111111111110000011000000000000000
11111111111111111110000010000000000000000
11111111111111111110000010000000000000000
11111111111111111110000000000000000000000